The Martian	During a manned mission to Mars, Astronaut Mark Watney is presumed dead after a fierce storm and left behind by his crew. But Watney has survived and finds himself stranded and alone on the hostile planet. With only meager supplies, he must draw upon his ingenuity, wit and spirit to subsist and find a way to signal to Earth that he is alive.	2015-10-02	6.0
Knock Knock	Two young women show up at the home of a married man and begin to systematically destroy his idyllic life.	2015-10-09	5.0
Nocturna	Two New Orleans detectives become embroiled in a centuries-long feud between two secretive factions of vampires while investigating a runaway child's case. Torn between their everyday lives and the dangerous lure of immortality, the detectives must race to destroy the evil Moldero clan.	2015-10-06	3.0
The Walk	The story of French high-wire artist Philippe Petit's attempt to cross the Twin Towers of the World Trade Center in 1974.	2015-10-02	4.4
Macbeth	Feature film adaptation of Shakespeare's Scottish play about General Macbeth whose ambitious wife urges him to use wicked means in order to gain power of the throne over the sitting king, Duncan.	2015-10-02	4.6
Pan	The story of an orphan who is spirited away to the magical Neverland. There, he finds both fun and dangers, and ultimately discovers his destiny -- to become the hero who will be forever known as Peter Pan.	2015-10-09	4.5
Steve Jobs	Set backstage at three iconic product launches and ending in 1998 with the unveiling of the iMac, Steve Jobs takes us behind the scenes of the digital revolution to paint an intimate portrait of the brilliant man at its epicenter.	2015-10-09	6.9
The Final Girls	A young woman grieving the loss of her mother, a famous scream queen from the 1980s, finds herself pulled into the world of her mom's most famous movie. Reunited, the women must fight off the film's maniacal killer.	2015-10-09	2.4
The Dressmaker	A glamorous woman returns to her small town in rural Australia. With her sewing machine and haute couture style, she transforms the women and exacts sweet revenge on those who did her wrong.	2015-10-01	9.5
Blunt Force Trauma	Follows the journey of John and Colt, gunfighters and sometime lovers, on parallel but very different journeys through an underground dueling culture.	2015-10-05	5.3
Freeheld	New Jersey car mechanic Stacie Andree and her police detective girlfriend Laurel Hester both battle to secure Hester's pension benefits after she was diagnosed with a terminal illness.	2015-10-02	9.5
Maryland	An ex-soldier with PTSD is hired to protect the wife and child of a wealthy Lebanese businessman while he's out of town.	2015-09-30	4.0
Marguerite et Julien	Julien and Marguerite de Ravalet, son and daughter of the Lord of Tourlaville, have loved each other tenderly since childhood. But as they grow up, their affection veers toward voracious passion.	2015-09-30	3.7
Fathers and Daughters	A Pulitzer-winning writer grapples with being a widower and father after a mental breakdown, while, 27 years later, his grown daughter struggles to forge connections of her own.	2015-10-01	0.0
Iron Giant - Signature Edition	When “The Iron Giant” arrived in theaters in 1999, it was hailed as an “instant classic” by Joe Morgenstern of The Wall Street Journal and the world soon learned another “giant” had arrived as well: filmmaker Brad Bird, who made his stunning directorial debut with this film and has gone on to win two Oscars, as well as worldwide acclaim for his work on both animated and live-action features.  Winner of 9 Annie Awards, “The Iron Giant” is being remastered and enhanced with two all-new scenes! The Iron Giant: Signature Edition will be re-released in theaters across North America for a special Fathom Events screening on Wednesday, September 30 with an encore event on Sunday, October 4.	2015-09-30	0.0
Junun	Paul Thomas Anderson joined his close friend and collaborator Jonny Greenwood on a trip to Rajasthan in northwest India, where they were hosted by the Maharaja of Jodhpur, and he brought his camera with him. Their destination was the 15th-century Mehrangarh Fort, where Greenwood was recording an album with Israeli composer Shye Ben Tzur and an amazing group of musicians.	2015-09-30	10.0
Lamb	When an Ethiopian boy moves in with distant relatives he takes his pet sheep with him but the upcoming holidays spell danger for his beloved friend.	2015-09-30	0.0
Howl	When passengers on a train are attacked by a creature, they must band together in order to survive until morning.	2015-10-01	3.0
Masterminds	A night guard at an armored car company in the Southern U.S. organizes one of the biggest bank heists in American history.	2015-10-09	6.3
The Dick Knost Show	Bruce Sweeney (Last Wedding) directs this keenly observed and wickedly funny media satire about a self-absorbed sports-radio shock jock whose controversial social-media missive makes him the target of network scrutiny.	2015-10-01	0.0
The Lobster	The Lobster is a story about love, without being a conventional love story. It observes the ways and reasons certain people come together to form couples, while others don’t. It is a story about the terrifying effects of solitude, the fear of dying alone, the fear of living alone and, above all, the fear of living with someone. Forcing ourselves to like someone is one kind of suffering; trying to find someone we really like is a different sort of suffering. The Lobster tries to discover synonyms for love in words such as fear, norms, deadlines, matching, synchronicity, naivety, prosperity and lies.	2015-10-16	6.0
Crimson Peak	Legendary Pictures’ Crimson Peak, a co-production with Universal Pictures, is a haunting gothic horror story directed by the master of dark fairy tales, Guillermo del Toro (Pan’s Labyrinth, Hellboy series, Pacific Rim), written by del Toro &amp; Matthew Robbins and starring Mia Wasikowska, Jessica Chastain, Tom Hiddleston, Charlie Hunnam and Jim Beaver. In the aftermath of a family tragedy, an aspiring author is torn between love for her childhood friend and the temptation of a mysterious outsider. Trying to escape the ghosts of her past, she is swept away to a house that breathes, bleeds… and remembers.	2015-10-16	4.1
Hell & Back	Two best friends set out to rescue their pal after he's accidentally dragged to hell.	2015-10-02	3.6
Bridge of Spies	An American lawyer is recruited by the CIA during the Cold War to help rescue a pilot detained in the Soviet Union.	2015-10-16	2.8
춘희막이	Back in the days, Choi Maggi an old lady accepted Kim Chunhee as her husband’s second wife to continue the family tree as she has lost her two sons in the past due to measles and typhoon. This story is more dramatic than any drama because even after the death of their husband they live together. The director does a good job in expressing the lives of these two old ladies without any exaggeration. The daily life and relationship of the two ladies eating, washing and working is described in a very detailed script. Through this film you will feel the eager echo of the proposition of life that exceeds the standard of happiness and misfortune. (KIM Youngjin)	2015-09-30	0.0
Terug Naar Morgen	What would you do if you could change the past?	2015-09-30	0.0
Je suis à vous tout de suite	No Information Available	2015-09-30	0.0
This is Happening	THIS IS HAPPENING tells the story of an estranged brother and sister (played by James Wolk and Mickey Sumner) forced to go on the road together to track down their fugitive grandmother (Cloris Leachman). What begins as a comedic tale of a broken family forced to come together under the pressures of an absentee father (Judd Nelson) evolves into a journey about learning to find your family in order to find yourself.  Directed by:	Ryan Jaffe  Starring:  Cloris Leachman, Mickey Sumner, James Wolk, Judd Nelson	2015-10-02	0.0
Navy Seals vs. Zombies	A team of highly skilled Navy SEALS find themselves embarking on the battle of their lives when they come face-to-face with the undead. After a deadly outbreak occurs in New Orleans, the SEALS must fight for their lives, and the city, against an army of zombies.	2015-10-08	4.0
Ni le ciel, ni la terre	Afghanistan 2014  As the withdrawal of troops approaches, Captain Antarès Bonassieu and his squad have been assigned a surveillance mission in a remote valley of Wakhan, on the border of Pakistan. Despite Antarès and his men’s determination, control of the secluded valley will slowly fall out of their hands. One dark night, soldiers begin to mysteriously disappear in the valley.	2015-09-30	0.0
Term Life	If Nick Barrow can stay alive for 21 days, he'll die happy. Everyone Nick knows wants him dead; Mob bosses, contract killers, and dirty cops. Performing the last act of a desperate man, Nick takes out a million dollar insurance policy on himself, payable to his estranged daughter. The problem? The policy doesn't take effect for 21 days. Nick knows they'll be lucky to be alive for twenty-one hours.	2015-10-02	0.0
The Dead Room	When a terrified family flees a desolate southern New Zealand farmhouse, two cynical scientists and a young psychic are sent to investigate their claims of a haunting. There they encounter a powerful spirit that will protect the house's secrets at all costs.	2015-10-01	0.0
Louder Than Bombs	Three years after his wife, acclaimed photographer Laura Freed, dies in a car crash, Gene keeps everyday life going with his shy teenage son, Conrad.  A planned exhibition of Laura’s photographs prompts Gene's older son, Jonah, to return to the house he grew up in—and for the first time in a very long time, the father and the two brothers are living under the same roof.  Underneath the affection and friction that is a part of restored family life between these three, we feel the striking loss that marks each of them.  At the same time, the three have completely different memories of the exceptional woman who influenced their lives so profoundly.  Did any of them really know her?	2015-10-01	0.0
Troublemakers: The Story of Land Art	The titular troublemakers are the New York–based Land (aka Earth) artists of the 1960s and 70s, who walked away from the reproducible and the commodifiable, migrated to the American Southwest, worked with earth and light and seemingly limitless space, and rethought the question of scale and the relationships between artist, landscape, and viewer. Director James Crump has meticulously constructed Troublemakers from interviews (with Germano Celant, Virginia Dwan, and others), photos and footage of Walter De Maria, Michael Heizer, Robert Smithson, Nancy Holt, and Charles Ross among others at work on their astonishing creations.	2015-10-01	0.0
A Fighting Chance	In order to get his family back, Frank must transform internally and overcome his fear instilled in him by his father since childhood. And in the process of his turbulent spiritual journey and self-discovery, he creates a Martial Arts "Transformational Training Method: H.I.G.H. K.E.Y. F.I.T.N.E.S.S. which in turn he utilizes to lead and metamorphosize an inner-city High School Karate team from last place to first place in the state. These teenagers get to realize their unlimited God-given potential to overcome barriers and break down their limited beliefs and become positive contributors to society.	2015-10-02	5.3
バクマン。	Bakuman is a slice-of-life drama about two high school students who want to become manga artists.	2015-10-01	0.0
Arbeit macht das Leben süß, Faulheit stärkt die Glieder	Documentary about an alternative old age home in Rumania.	2015-10-01	0.0
Helen Keller vs. Nightwolves	Helen Keller vs. Nightwolves tells the shocking story of how a group of Nightwolves terrorized a tiny village taking people's hearing and eye sight... and the one woman who fought back.	2015-10-01	0.0
Perfect Horse	No Information Available	2015-10-01	0.0
Tomorrow	A film about soldiers trying to reintegrate into society after tours of duty.	2015-10-01	0.0
Shout Gladi Gladi	Shout Gladi Gladi is a documentary about hope. It tells the story of one woman's quest to cure fistula and save mother's lives in Africa. Shot in Malawi and Sierra Leone (just prior to the Ebola crisis) this is an intense portrait of the people suffering from fistula and the struggle of those who are not only trying to fix this condition but curtail it through better maternal health care. In addition, it is about women's empowerment, specifically through a radical device from BBOXX, a solar powered generator that provides the women not only with electricity in a region where there is none but also as a means to make money by charging cell phones.	2015-10-01	0.0
Penis Boy	A dark comedy about a retired high class escort that gets pulled in for one last job and on the way contemplates suicide.	2015-10-02	4.5
The Mind's Eye	The Mind’s Eye follows a drifter with telekinetic abilities who targets a doctor who is creating a synthetic telekinetic power serum.	2015-10-01	0.0
He Named Me Malala	A look at the events leading up to the Taliban's attack on the young Pakistani school girl, Malala Yousafzai, for speaking out on girls' education and the aftermath, including her speech to the United Nations.	2015-10-02	1.8
B, la película	No Information Available	2015-10-01	0.0
Little Bear	A short story of friendship and Imagination.	2015-10-01	0.0
Naanum Rowdydhaan	Naanum Rowdydhaan (English: I'm also a rowdy) is an upcoming Indian Tamil film written and directed by Vignesh Shivan, in his second venture after Podaa Podi (2012). The film features Vijay Sethupathi and Nayantara in the lead roles. Produced by actor Dhanush under his banner Wunderbar Films, the film features music composed by Anirudh Ravichander.	2015-10-02	0.0
Puli	Puli is an upcoming Indian Tamil film	2015-10-01	0.0
Dismembering Christmas	At a vacation winter lake house, seven high school seniors are attacked by a madman out for revenge.	2015-10-01	0.0
Vai Que Cola - O Filme	No Information Available	2015-10-01	0.0
J. Kessels	J. Kessels is the story of the bizarre road trip taken by a French literary pulp writer with his favourite character J. Kessels. The journey takes them from Tilburg to the Hamburg Reeperbahn in Kessels' old American 'Kamikaze' clunker as they seek out cheating dealer. When they get there they find a corpse in the trunk of the Kamikaze: easy to find, but how do you get rid of it?	2015-10-01	0.0
Just Go	In an effort to prove that adventure is not only accessible, but affordable, four guys road trip 6,000 miles across the country in a beat up 80's hatchback, surviving on less money than the average American spends on food per week.	2015-10-01	0.0
By Our Selves	Andrew Kötting's film retraces John Clare's journey from Epping Forest to Northamptonshire accompanied by a straw bear.	2015-10-01	0.0
Cerca de tu casa	No Information Available	2015-10-01	0.0
Vai que Dá Certo 2	No Information Available	2015-10-01	0.0
Guibord s'en va-t-en guerre	Guibord is an independent Member of Parliament who represents Prescott-Makadewà-Rapides-aux Outardes, a vast county in Northern Quebec. As the entire country watches, Guibord unwillingly finds himself in the awkward position of holding the decisive vote to determine whether Canada will go to war. Accompanied by his wife, his daughter and an idealistic intern from Haiti named Sovereign, Guibord travels across his district in order to consult his constituents. While groups of lobbyists get involved in a debate that spins out of control, the MP will have to face his own conscience. 'My Internship in Canada' is a biting political satire in which politicians, citizens and lobbyists go head-to-head tearing democracy to shreds.  Film starring Suzanne Clément, Patrick Huard and Mardy Men	2015-10-02	0.0
Death Reel	An eccentric collector of rare movies shot on super-8 dies and his library is sold off. Film Fanatic Marty Weeks successfully bids on several reels of film and rushes home to watch them. The projector clatters to life an the light flickers on the screen as terror unspools in early short films made by the Polonia bros between 1983 and 1985, right before their switch to the new video format. Witness the celluloid horror of maniacal cults, scarecrow vengeance, and even an Aqua-Maniac! Watch as Death Reel unfolds and the fevered beginnings of the Polonia Bros gets you in its death grip!!!!!!	2015-10-01	0.0
Tell Tale Lies	Four friends at a prestigious university whose promising futures are jeopardized when they become connected to the accidental death of a classmate. When another student says she knows about their involvement, the friends panic and start to plot her murder.	2015-10-09	0.0
Goosebumps	A young kid teams up with the niece of young adult horror author R.L. Stine after the writer's imaginary demons are set free on the town of Greendale, Maryland.	2015-10-16	6.0
Beasts of No Nation	A drama based on the experiences of Agu, a child soldier fighting in the civil war of an unnamed African country.	2015-10-16	8.5
Ville-Marie	Monica Bellucci stars in the second feature by Quebec director Guy Édoin, about four people whose very different lives intersect one fateful night in downtown Montreal.	2015-10-08	10.0
WWE Live from Madison Square Garden	Live from Madison Square Garden is an upcoming professional wrestling event produced by WWE. It will take place on October 3, 2015 and will air exclusively on the WWE Network. The event is hailed as a part of Brock Lesnar's Go To Hell Tour and his return to Madison Square Garden in his first match in the arena since his original departure from the company in 2004.	2015-10-03	0.0
Inji Iduppazhagi	Size Zero is forthcoming bilingual romantic Indian film directed by Prakash Kovelamudi, shot in Telugu and Tamil. Produced by Prasad V Potluri, the film features Arya and Anushka Shetty in the lead roles. The film's Tamil version is titled Inji Iduppazhagi, and began production in early 2015.	2015-10-02	0.0
Taikon	She has been called the Martin Luther King of Sweden. This documentary about Katarina Taikon depicts one of our most beloved children's literature writers and human rights champions, as well as the Sweden she fought against, with, and for.	2015-10-02	0.0
Urumeen	Urumeen is an upcoming Tamil fantasy thriller film written and directed by newcomer Sakthivel Perumalsamy. It stars Bobby Simha, Kalaiyarasan and Reshmi Menon. Produced by Axess Film Factory, the film has cinematography by Ravindranath Guru and music composed by Achu Rajamani.	2015-10-02	0.0
Shisha no Teikoku	The story of The Empire of Corpses takes place in 19th century Europe, and revolves around John Watson. He is scouted by the government to become a secret agent- However, Watson lives in a world where "Frankensteins"- human corpses that are re-purposed with a false soul in order to use them as laborers- are used to improve industrial development.	2015-10-02	0.0
Circle	Held captive and faced with their imminent executions, fifty strangers are forced to choose the one person among them who deserves to live.	2015-10-02	0.0
Signed, Sealed, Delivered: The Impossible Dream	The Postables work against the clock decoding a letter to rescue a soldier in Afghanistan and reunite her with her family, while Rita competes for the National Miss Special Delivery title in Washington, D.C. Stars Eric Mabius, Kristin Booth, and Crystal Lowe..	2015-10-04	0.0
Meadowland	After their son disappears, Sarah and Phil search for meaning, trashing around in a wayward haze. Phil starts to lose sight of his morals. Sarah takes off on a potentially disastrous journey, falling deeper into her own fever dream.	2015-10-16	0.0
劇場版 蒼き鋼のアルペジオ ‐アルス・ノヴァ‐ Cadenza	Second movie of Aoki Hagane no Arpeggio: Ars Nova which will be an entirely brand-new work.	2015-10-03	0.0
Don't Blink: Robert Frank	The life and work of Robert Frank—as a photographer and a filmmaker—are so intertwined that they're one in the same, and the vast amount of territory he's covered, from The Americans in 1958 up to the present, is intimately registered in his now-formidable body of artistic gestures. From the early '90s on, Frank has been making his films and videos with the brilliant editor Laura Israel, who has helped him to keep things homemade and preserve the illuminating spark of first contact between camera and people/places. Don't Blink is Israel's like-minded portrait of her friend and collaborator, a lively rummage sale of images and sounds and recollected passages and unfathomable losses and friendships that leaves us a fast and fleeting imprint of the life of the Swiss-born man who reinvented himself the American way, and is still standing on ground of his own making at the age of 90.	2015-10-04	0.0
Even Lambs Have Teeth	Two wronged women dish out vigilante justice ala Kill Bill’s “Bride”.	2015-10-03	0.0
ビッグオーダー	The wraparound jacket band on the seventh compiled volume of Sakae Esuno's Big Order manga is announcing on Monday that the eighth volume will bundle an original anime Blu-ray disc. The limited edition volume with the bundled anime is slated to ship in Japan on October 3.  The story centers on an introverted high school student named Eiji Hoshimiya with a huge secret—he wished for the destruction of the world when he was younger. Fairies give certain people special powers called Orders, and what Order Users can do with their power depends on their wishes. Ten years after the Great Destruction, Eiji struggles to come to terms with his immense power.	2015-10-03	0.0
Akron	Benny, a college freshman at the University of Akron, Ohio meets and falls for fellow freshman Christopher at a football game. With the support of their families and friends they embark on a new relationship. But a tragic event in the past involving their mothers soon comes to light and threatens to tear them apart.	2015-10-06	0.0
Room	Jack is a young boy of 5 years old who has lived all his life in one room. He believes everything within it are the only real things in the world. But what will happen when his Ma suddenly tells him that there are other things outside of Room?	2015-10-14	8.0
Heart Like a Hand Grenade	More than 10 years after the release of Green Day's American Idiot, the 2015 Rock and Roll Hall of Fame Inductees present this time capsule rock doc that takes us inside the making of their award-winning punk rock opera.	2015-10-15	0.0
Must alpinist	Ghost Mountaineer is a feature film with some hints of horror, based on actual events in Siberia back in Soviet times. A group of Estonian students on a winter hiking trip suddenly find themselves in the middle of bloodcurdling events in a Buryatian village.  Olle, a closed off group leader disappointed in his mates, disappears in the mountains in the last day of the trip. Open-minded and adventurous Eero and the rest of the hikers are facing a situation they at first do not want to, but later can not solve. But no one is prepared for devastation seemingly conducted by the vanished group leader Olle.  In strange country and amidst strange people, the group will soon find out that past actions and vengeance do not know the thin line between life and death.	2015-10-09	0.0
The Witness	A brother's journey to unravel the truth about the mythic death and little known life of Kitty Genovese, who was reportedly murdered in front of 38 witnesses and has become the face of urban apathy.	2015-10-06	0.0
Fatima	Fatima, a Moroccan-born woman who now lives in France with her two teenage daughters, with whom she is barely able to communicate.	2015-10-07	0.0
American Backwoods: Slew Hampshire	In June of 1994, one of the most brutal mass slaughters in history occurred in the backwoods of northern New England. Four months later, history is about to repeat itself. The end of summer signals the brink of manhood for a group of lifelong friends who proudly call New Hampshire their home. But when they embark upon a local rite of passage - traveling north for one final weekend of debauchery together - it just might prove to be their final weekend PERIOD, as this rite is doomed to go frightfully wrong. When they find themselves ensnared in a struggle for survival amongst a sinister hunting party, a bloodthirsty tribe AND a mythical beast, what began as a comedy of errors devolves into an all-out Darwinian duel to the death, and less than 24 hours will pass before a slew of lives have been claimed and the last of the living remains.	2015-10-06	10.0
NXT TakeOver: Respect	NXT TakeOver: Respect is an upcoming major professional wrestling show in the NXT TakeOver series that is scheduled to take place on October 7, 2015, produced by WWE, showcasing its NXT developmental brand, and will be streamed live on the WWE Network. It will be held at Full Sail University in Winter Park, Florida. The show is slated to feature the semi-finals and finals of the Dusty Rhodes Tag Team Classic tournament.	2015-10-07	0.0
Singh is Bliing	Singh Is Bling is an upcoming Bollywood action comedy film directed by Prabhu Deva and produced by MetroNet Multimedia (P) Ltd., under Grazing Goat Pictures.The film stars Akshay Kumar and Kriti Sanon in lead roles.  It also marks the return of Akshay Kumar in a Punjabi Sardar character, after the 2008 comedy film Singh is Kinng. Expected to release on 31st July 2015, Singh is Bling is the second actor-director collaboration between Kumar and director Prabhu Deva after their successful 2012 film Rowdy Rathore.	2015-10-02	0.0
What We Become	A family of four is quarantined in their home as a virulent strand of the flu spreads into town and they are forced to the extreme to escape alive.	2015-10-10	0.0
Un etaj mai jos	Film about a man who bears witness to a domestic quarrel that ends in murder.	2015-10-07	0.0
Jazbaa	After her daughter is kidnapped, a lawyer is forced to defend a criminal in exchange for her daughter's freedom.	2015-10-09	0.0
ヒーローカンパニー	"A hero" is a job that in the face of danger and adversity or from a position of weakness, display courage and the will for self sacrifice. Would you like to work as such a hero in our company? You may transform, manipulate a huge robot or fight as a squad. Shall we realize your dream in our "Hero Company"?!	2015-10-05	0.0
I Spit on Your Grave 3: Vengeance Is Mine	Jennifer Hills (Sarah Butler) is still tormented by the brutal sexual assault she endured years ago (I SPIT ON YOUR GRAVE 2010). She’s changed identities and cities, reluctantly joining a support group where she begins to piece together a new life. But when her new friend’s murderer goes free and the tales of serial rapists haunt her, Jennifer will hunt down the men responsible and do what the system won’t – make them pay for their crimes in the most horrific ways imaginable. Only this time, no jury may be able to save her.	2015-10-09	0.0
Rudhramadevi	The story of queen Rudrama Devi's reign in southern India during the 13th century.	2015-10-09	0.0
Truth	A behind-the-scenes look at news anchor Dan Rather during his final days at C.B.S. News when he broadcast a damaging report about how President Bush relied on privilege and family connections to avoid fighting in the Vietnam War.	2015-10-16	0.0
Experimenter	Based on the true story of famed social psychologist Stanley Milgram, who in 1961 conducted a series of radical behavior experiments that tested ordinary humans’ willingness to obey authority by using electric shock. We follow Milgram from meeting his wife through his controversial experiments that sparked public outcry.	2015-10-16	8.0
Re-Kill	It's been 5 years since the outbreak that wiped out 85% of the world's population, but the war between Re-Animates (Re-Ans) and Humans wages on. Most of the major cities are still uninhabitable. Within the few surviving cities, the Re-Ans have been segregated into "zones" and are policed by the R-Division of the QUASI S.W.A.T. Unit who hunt to re-kill the Re-Ans in the hope of quelling a second outbreak.	2015-10-16	4.0
Martian Land	In the distant future, mankind lives on Mars, in cities that resemble those once found on Earth, protected from the alien atmosphere by dome-like force-fields. When a massive sandstorm breaks through the dome and destroys Mars New York, those in Mars Los Angeles must figure out how to stop the storm before it wipes them out next.	2015-10-06	0.0
Monster High: Boo York, Boo York	The ghouls are taking a bite out of Boo York! The De Niles are hoping to meet their dynastic destiny and carve out a new empire, while Catty Noir is trying to find her music. Together the ghouls are taking Boo York by storm.	2015-10-19	0.0
Villmark 2	An old sanatorium is deteriorating in an isolated forest in the mountains. The elderly janitor is still living there to ensure that no one access the dangerous building. Five contract workers have taken on the task of tracking the huge building for hazardous waste before it's demolished. Over 300 rooms and kilometres of pipelines have to be screened in three days. They realize that the job is more than a search for asbestos and mercury when they encounter the building's frightening past. Water is gushing from the old pipes, and brings the work to a halt. An attempt to close the water intake leads them to the dark cellar, where they discover the horrible secrets from the sanatoriums past. You can demolish a building, but never remove the past.	2015-10-09	0.0
Popoz	No Information Available	2015-10-08	0.0
Prophet’s Prey	When Warren Jeffs rose to Prophet of the Fundamentalist Church of Latter Day Saints, he took control of a religion with a history of polygamous and underage marriage. In a short time, Warren managed to expand these practices and the power of his position in unprecedented ways. He bridged the gap between sister wives and ecclesiastically rape, befuddling the moral compass of his entire congregation. The film examines Warren Jeffs' life and shows how he became a worshipped and adored Prophet. Warren has a devout following numbering in the tens of thousands - many of whom would give their life at any moment with just one word from the Prophet. Despite a trail of abuse and ruined lives, Warren has maintained his grip on power.	2015-10-10	0.0
Keet & Koen en de speurtocht naar Bassie & Adriaan	Keet &amp; Koen are street artists and entertainers in a theme park. In this family movie their mission is to search for missing clown Bassie and acrobat Adriaan. Bassie &amp; Adriaan are very well known among the young and old and have received an award for their great merit as people rescuers. Their eternal enemy, the old Baron, wants to prevent this of course and he commands his cousin 'Jonkheer' to abduct Bassie &amp; Adriaan. Keet &amp; Koen prove to be full successors to Bassie &amp; Adriaan as they proceed into the exciting search for the famous duo that has been kidnapped.	2015-10-07	0.0
Ladrones	In “Ladrones,” the sequel to heist comedy “Ladron que roba a ladron” (To Rob a Thief), Alejandro Toledo comes out of his retirement from crime to help a community reclaim land stolen from them by a beautiful but ruthless businesswoman and her clan.	2015-10-09	0.0
Paranormal Activity: The Ghost Dimension	The sixth installment in the Paranormal Activity franchise.	2015-10-21	7.3
Er ist wieder da	No Information Available	2015-10-08	0.0
Taj Mahal	One evening, while her parents go out for dinner, 18-year-old Louise, alone in her hotel room at Taj Mahal Mumbai, hears strange noises out in the corridor. Within minutes, she realises that a terrorist attack is underway. Her only connection to the outside world is her cell phone, which allows her to maintain contact with her father, who is desperately trying to reach her from the other side of a city that has been plunged into chaos. Louise must spend a long night alone in the face of danger. She will never be the same again.	2015-10-07	0.0
Just Let Go	After surviving a drunk driving accident that killed his pregnant wife and two kids, Chris Williams struggles to 'just let go' and forgive the young man who caused it.	2015-10-09	0.0
L'étudiante et Monsieur Henri	No Information Available	2015-10-07	0.0
Une enfance	As summer drags by, 13-year-old Jimmy, forced by circumstance to become an adult too soon, runs up against the limits of his small hometown and his turbulent life, caught between a mother on the slide and a stepfather who keeps her down.	2015-10-15	0.0
Inspektor Jury lichtet den Nebel	No Information Available	2015-10-07	0.0
Big Stone Gap	A story centered around a transitional point in the life of Ave Maria Mulligan, the heart of her community in the Appalachian Mountains of Virginia.	2015-10-09	0.0
El apóstata	The third feature film by Federico Veiroj tells the tale of a young boy desperate to escape the faith passed down from his parents as he looks back over his past, his scars, the marks left by guilt and desire.	2015-10-09	0.0
Μαριονέτες	Marionetes is a mystery story filmed in a dark, unknown and full of temptations Athens	2015-10-08	6.8
Enragés	After a bank job goes badly wrong, three desperate criminals take a young woman and a father and child hostage - it's the beginning of a frantic and violent road trip that not all of them will survive.	2015-09-30	7.8
Upside Down Feeling	Arthur, a young boy with a wild imagination, develops a preoccupation with death and disease and begins to explore mortality in the vivid images he sees in the movies and through a strange visitor from the past.	2015-10-12	0.0
Infección zombie	No Information Available	2015-10-08	0.0
Ki	During a dream, 7 year old Yuki is reunited with her sister Iwa (11), who has recently passed away. Together, they share an exciting adventure and along this journey, Yuki is forced to conquer her anxieties. Ultimately, she has to face her biggest fear: to live her life without her sister.	2015-10-15	0.0
Jesse Stone: Lost in Paradise	Once a Los Angeles homicide detective, Police Chief Jesse Stone now presides over the quiet, seaside village of Paradise, Massachusetts. When the facts don't add up in a brutal Boston-area murder case, Jesse opens an investigation filled with surprises, unlikely suspects and grave danger. Though it's widely believed the murder was committed by an incarcerated serial killer, Jesse suspects another killer is at large and is hell-bent on bringing him to justice.	2015-10-18	0.0
Back In Time	Cast, crew, and fans explore the classic Back to the Future time-travel trilogy's resonance throughout our culture 30 years after Marty went back in time.	2015-10-20	0.0
Invisible Sister	Teenager Cleo's school science project goes quite awry, causing her popular older sister Molly to go invisible.	2015-10-09	0.0
Worlds Apart	Three separate narratives each following a love story between a foreigner and a Greek. Each story represents a different generation falling in love during a time of socioeconomic turmoil that dominates Southern Europe as a whole, only to connect as a single story in the end.	2015-10-15	0.0
The Nobodies	In 1993, Alabama based amateur filmmaker Warren Werner shot his first feature film, Pumpkin, on VHS. With a budget of only $600, a cast of friends, family, and unknown talent, the movie premiered at the local civic center and generated an immediate backlash from the community. Rumors that Warren and his girlfriend Samantha Dixon engaged in Satanic rituals began to spread throughout town. In the months following the premiere, Warren and Samantha committed suicide. The following year, another group of filmmakers began shooting a documentary about the deaths of Warren and Samantha. The documentary project was never completed, and Pumpkin was never released. The Nobodies is Warren Werner's Pumpkin, in it's entirety, cut together with the remaining documentary footage of the director's life and death.	2015-10-13	0.0
Miles Ahead	An exploration of the life and music of Miles Davis.	2015-10-10	0.0
Winter Buoy	A poetic and intimate story about the guardian angels behind addicts who want to start a new life.	2015-10-09	0.0
A Faster Horse	David Gelb (Jiro Dreams of Sushi) tackles another venerable, beloved, and long-standing institution: the Mustang, crown jewel of the Ford fleet. Only this institution is in turmoil. As the fiftieth anniversary of the Mustang approaches and the car industry struggles through the deepest trough of the financial crisis, Ford launches a redesign. Now the jobs of workers at Ford’s Flat Rock Assembly Plant, the expectations of the thousands of Mustang devotees, and the livelihood of the city of Detroit are all placed squarely on the shoulders of Dave Pericak. As chief program engineer, he will guide the 2015 Mustang from assembly floor to showroom—if only he can get that vibration out of the steering wheel.	2015-10-08	0.0
Breakfast at Ina's	Famous for its Heavenly Hots (pancakes topped with fruit compote), Ina’s was a Chicago breakfast institution. Every customer received a warm welcome from proprietor and chef Ina Pinkney, the “Breakfast Queen.” After 33 years in the restaurant business, Pinkney retired in 2013. Following the restaurant’s final month, Breakfast at Ina’s celebrates a beloved Chicago eatery and a woman who achieved her dream against the odds.	2015-10-18	0.0
Winter on Fire: Ukraine's Fight for Freedom	A documentary on the unrest in Ukraine during 2013 and 2014, as student demonstrations supporting European integration grew into a violent revolution calling for the resignation of President Viktor F. Yanukovich.	2015-10-09	0.0
The Exorcism of Molly Hartley	Taking place years after The Haunting of Molly Hartley, who now, as an adult, has fallen under the possession of an evil spirit and must be exorcised by a fallen priest before the devil completely takes her.	2015-10-09	0.0
La Playa De Los Ahogados	No Information Available	2015-10-09	10.0
3000 Layla	A young Palestinian schoolteacher gives birth to her son in an Israeli prison where she fights to protect him, survive and maintain hope.	2015-10-15	0.0
Death Valley	A film by T.J. Scott.	2015-10-20	0.0
Eloise	Four friends break into an abandoned insane asylum in search of a death certificate which will grant one of them a large inheritance. However, finding it soon becomes the least of their worries in a place haunted by dark memories.	2015-10-15	0.0
Down in the Valley	Sacramento and its mayor Kevin Johnson fight to keep their hometown NBA team.	2015-10-20	0.0
Ghost Meets World	When three teenage boys set out to make a documentary about a supposed ghost sighting, they end up stumbling upon a dead body, and must race against the clock to clear their names of the murder.	2015-10-16	0.0
Riley's First Date?	Riley, now 12, who is hanging out with her parents at home when potential trouble comes knocking. Mom's and Dad's Emotions find themselves forced to deal with Riley going on her first date.	2015-10-13	0.0
Film Kteer Kbeer	A dark comedy about brothers running a drug-dealing business out of their takeout pizzeria.	2015-10-11	0.0
Da Hai	It is a world within our world, yet unseen by any human, and the beings here control time and tide and the changing of the seasons. On the day Chun turns sixteen, she is transformed into a dolphin to explore the human world. She is rescued from a vortex by a human boy at the cost of his own life. Chun is so moved by the boy's kindness and courage that she decides to give him life again. But to do this, she must protect the boy's soul, a tiny fish, and nurture it to grow. Through adventure and sacrifice, love grows, yet now she must release him back to the sea, back to life in the human world.	2015-10-11	0.0
The Inhabitants	A young couple gets more than they bargained for when they buy an historic bed and breakfast in New England only to discover that the old house is hiding a dark secret within its walls.	2015-10-13	0.0
Light Years	A subtly nuanced drama that explores the toll that physical and mental illness can have on a family.	2015-10-14	0.0
D'Ardennen	A brutal home-jacking goes hopelessly wrong. Dave, one of the two robbers, manages to run off, leaving his brother Kenneth behind. Four years later, Kenneth is released from prison and much has changed. Dave has his life back on track and is trying to help Kenneth however possible, but is witnessing how the highly strung Kenneth tries to win back his ex-girlfriend Sylvie.	2015-10-14	0.0
Patchwork	A delightfully dark, Frankenstein-themed horror comedy about a re-animated corpse, made from the stitched together body parts of three murdered young women, that decides to go on a bloody quest to find their killer and avenge their deaths!	2015-10-15	0.0
Dede; Mehmet met de gele laarzen	Eleven year old Merel searches for her unknown biological Turkish grandfather.	2015-10-15	0.0
Zevenbergen	Tom and Marnix don't see any harm in doing everything together like they have always done, it is in their nature. Their parents and teachers think the boys are getting to old and try to seperate them. When the twin brothers both fall in love with the new girl Rosa, and she falls in love with them, they take drastic measures to stay together.	2015-10-15	0.0
Rijk!	No Information Available	2015-10-15	0.0
One Happy Day	No Information Available	2015-10-15	0.0
Cold Moon	Cold Moon takes place in tiny Babylon, Fla., where the granddaughter of Clark’s character is murdered by a mysterious assailant, her body sunk into the black waters of the Styx River — the river where her parents disappeared from their boat a decade earlier. Suspicion falls on a duplicitous banker and his wealthy father, played by Stewart and Lloyd.	2015-10-20	0.0
Greater Things	In this stunningly composed meditation on space and human relationships, an adrift Iranian architect, a disengaged Japanese couple, and a Lithuanian mixed martial arts fighter search for connection in modern Japan. From the stylishly designed shops of Tokyo to a minimalist glass suburban home to a mysterious tree house in the woods, Greater Things reveals the strange places we inhabit, and how they can both unite and divide us.	2015-10-16	0.0
Lumberjack Man	As the staff of Good Friends Church Camp prepares for a spring break filled with "Fun Under the Son", a demon logger rises from his sap boiler to wreak his vengeance and feast on flapjacks soaked in the blood of his victims.	2015-10-16	0.0
Trojan War	When Pete Carroll took over the football program at USC after the 2000 season, the once-great Trojans were under siege.  But thanks to his football knowledge, upbeat personality and recruiting skills, Southern Cal was soon back atop the college football world as home attendance skyrocketed, Carson Palmer, Matt Leinart and Reggie Bush won Heismans and the Trojans put together a 34-game winning streak.  As it would be later discovered, though, the program was committing sins that would result in lost scholarships, victories and one of those Heismans.  But those revelations didn’t come until after the national championship game in the 2006 Rose Bowl between USC and the University of Texas.  Featuring interviews with Carroll, Leinart and others inside the USC program at the time, “Trojan War” looks at Carroll’s nine-year USC reign through the prism of that game, considered one of the greatest in college football history.  It was also the beginning of the end.	2015-10-13	0.0
Amateur Teens	A modern tragedy about a group of 14-year-old schoolchildren whose daily life is shaped by the power of social media and ever increasing sexualisation through the Internet.	2015-10-15	0.0
Dancin' It's On	This coming of age Dance Film, in the spirit of Dirty Dancing, Karate Kid, and High School Musical - is about a young girl from Beverly Hills, Jennifer who is visiting her Father's Panama City Beach Hotel during Summer Break, and falls in love with a Young Boy, Ken who works as a Dishwasher. Even though both are from different backgrounds, they share the same passion... DANCE and partner with each other to enter the 2nd Annual Florida State-Wide Dance Contest. While preparing for the contest, Jennifer and Ken must overcome scheming dance partners, a meddling father, and their own doubts for their love to prevail.	2015-10-16	0.0
Km 31-2	A woman is searching for her son who got lost under mysterious circumstances.	2015-10-16	0.0
Belgica	The story of two brothers who, even though they have absolutely nothing in common, open a bar together that quickly becomes a regular hangout for nighthawks. Despite the success, they must soon face up to the difficulties inherent in running a family business. Their brotherhood turns into rivalry, through no fault of their own.	2015-10-14	0.0
Les Nouvelles aventures d'Aladin	No Information Available	2015-10-14	0.0
De Club van Sinterklaas & de verdwenen schoentjes	No Information Available	2015-10-14	0.0
Belles familles	No Information Available	2015-10-14	0.0
Suburra	No Information Available	2015-10-14	0.0
SCANDAL “Documentary film「HELLO WORLD」”	Documentary film from the HELLO WORLD tour of 2015	2015-10-17	0.0
מסווג חריג	Matan, a soldier in the IDF, sets off for a week of patrolling in a remote base. Overwhelmed with homesickness, he becomes an easy target for the other soldiers who make it their business to make his life hell. However, it is not long before strange things begin to happen to all of them.	2015-10-15	0.0
Kleine Ziege, sturer Bock	No Information Available	2015-10-15	0.0
unINDIAN	Single mum Meera (Tannishtha Chatterjee) is an Australian of Indian origin. Smart and independent, she has carved out a successful life for herself and her daughter...despite family pressure to find a 'nice Indian match'. Then Meera meets Will (Brett Lee), a blonde, blue-eyed Aussie charmer. But falling in love with an Australian is not only scandalous - it's unIndian! Does she do what her family wishes, or follow her heart?	2015-10-15	6.5
The French American	The French American is a drama film directed by Darla Rae	2015-10-15	0.0
Schellen-Ursli	No Information Available	2015-10-15	0.0
Nicht schon wieder Rudi!	No Information Available	2015-10-15	0.0
Koningsdag	No Information Available	2015-10-15	0.0
Nicht schon wieder Rudi!	No Information Available	2015-10-15	0.0
Dürrenmatt - Eine Liebesgeschichte	No Information Available	2015-10-15	0.0
Amama	The latest film from the Basque moviemaker, Asier Altuna. A family tale of conflict between the urban and rural worlds, past and present, parents and children. Two different ways of understanding life, and a grandmother who observes the world from deeply eloquent silence.	2015-10-16	0.0
The Infinite Happiness	Copenhagen’s “8 House,” an ultramodern loop of apartments created by architect Bjarke Ingels, reinvents the concept of “home.” Its 500 residents can traverse all nine floors by bike while their kids attend kindergarten on the ground floor. This exuberant documentary profiles the (mostly) happy residents, including a group of children who experience the best scavenger hunt ever, offering a hopeful, inspired picture of communal living by design.	2015-10-17	0.0
Móstoles no es lo que parece o la importancia de llamarse Encarna	No Information Available	2015-10-16	0.0
Shock Room	Breaking open Stanley Milgram's infamous 'Obedience to Authority' experiments, Shock Room questions whether we're really programmed to obey.	2015-10-16	0.0
Los miércoles no existen	No Information Available	2015-10-16	0.0
Vulcania	No Information Available	2015-10-16	0.0
Hell House LLC	Five years after an unexplained malfunction causes the death of 15 tour-goers and staff on the opening night of a Halloween haunted house tour, a documentary crew travels back to the scene of the tragedy to find out what really happened.	2015-10-16	0.0
Unnatural	Global climate change prompts a scientific corporation to genetically modify Alaskan polar bears with horrific and deadly results.	2015-10-16	0.0
Irudhi Suttru	Irudhi Suttru / Saala Khadoos is an upcoming bilingual sport drama film written and directed by Sudha Kongara Prasad. The film features R. Madhavan in the leading role as a boxing coach, and is being simultaneously made in Tamil and Hindi, under the title Saala Khadoos.	2015-10-16	0.0
Bad Guy #2	When you're the #2 Bad Guy, your days are usually numbered.	2015-10-16	0.0
Motley's Law	This captivating documentary follows tough-as-nails lawyer (and former Mrs. Wisconsin) Kimberley Motley, the only American allowed to practice law in Afghanistan. Motley defends US and European citizens caught in the country’s legal and political quagmire, even as she finds herself under threat of assassination. While Motley brazenly chastises Afghani judges on behalf of her clients, she must also balance the needs of her family a world away.	2015-10-15	0.0
Mania: A F*cked Up Lesbian Love Story	Two lesbian lovers are forced to flee their hometown after a brutal murder changes their lives forever.	2015-10-21	0.0
Amy Schumer: Live at the Apollo	With her unique blend of honesty and unapologetic humor, Amy Schumer is one of the funniest, freshest faces in the industry today. This October, Schumer's provocative and hilariously wicked mind will be on full display as she headlines her first HBO stand-up comedy special: 'Amy Schumer: Live at the Apollo.' Directed by Chris Rock, the one-hour special features the comedian talking about her life and was taped before a live audience at New York’s iconic Apollo Theater.  Schumer is the creator, star, writer and executive producer of the Peabody Award-winning and Emmy®-nominated series 'Inside Amy Schumer.' She won a Critics’ Choice Television Award for the series this year. Schumer can currently be seen in the feature film 'Trainwreck,' which she wrote and stars in and Judd Apatow directed. Schumer’s other credits include 'Louie,' 'Delocated,' as well as HBO’s 'Girls' and 'Curb Your Enthusiasm.'	2015-10-17	0.0
The Hard Stop	Delves into the shooting death of Mark Duggan, a young black British man, by London Metropolitan Police in 2011.	2015-10-17	0.0
Not Film	Documentary about Samuel Beckett's 'Film.'	2015-10-17	0.0
Six Angry Women	A jury deliberates.	2015-10-20	0.0
Adama	12 year-­old Adama lives in a remote village in West Africa, sheltered by the Cliffs. Out, beyond, lies "the land of breaths", the kingdom of wicked spirits hungry for war. When Samba, his elder brother, suddenly vanishes from the village, Adama decides to set off in search of him. Accompanied first by Abdou, a tragically lucid griot, then by Maximin, a street urchin who is his own negative twin, he crosses a Europe in the grip of war. We're in 1914. Borne by the energy of desperation and the poetry of childhood, Adama travels to the hell of the frontline in order to free his brother. Ultimately, Adama's love for his brother will open an unexpected way to his initiatory journey.	2015-10-21	0.0
Between Two Worlds	The tale of a young writer trying to get over the girl that left him behind and survive the intricacies of the capital's nightlife with only the help of his hard partying, wisecracking friends as they drag him from one London nightspot and party to the next.	2015-10-19	0.0
